++++++++++++++++++++++
+ +     ++ ++        +
  +  ++     + ++++++++
+ + ++ ++  ++++  ++ ++
+ +  +  ++ + +    + ++
+ +   +     ++ ++  +++
+ +++ + + ++   ++  +++
+     +    +  +     ++
+++++ + ++   ++   +S++
++++++++++++++++++++++